###.######
#     ####
# #   ##p#
##  #    #
##o##     
#.      # 
##.###    