###.######
#     ####
# .   ##p#
##      o#
## ##     
#.      # 
##.###    